   W                
   W       W        
   WWW     W        
           W        
W WWW          W    
    W          WWWW 
    W     W    W    
    W     W    W   W
          W    W   W
                   W
WW   WWWWWWW   WWWWW
 W            W     
 W     W      W     
       W      W     
WWWWWWWW            