                    
   WWWWW   W        
           W        
           W        
WWWWW          W    
    W          W    
    W     W    W    
    W     W    W    
          W    W    
                    
WWWWWWWWWWWW   WWWWW
              W     
       W      W     
       W      W     
WWWWWWWW            